You and your friend Frank wanted to try the new breakout game in Waikiki . This breakout game is not like anyother though because it is not a room that you are trying to breakout from, it is a house!. You and Frank had reserved a day two months in advance to try the new breakout house. You and Frank get blindfolded and get placed in the basement, where you will begin your breakout.

Breakout
An Interactive Fiction by Duke Shimabukuro
Release 1 / Serial number 170227 / Inform 7 build 6M62 (I6/v6.33 lib 6/12N) SD

Basement
It's dark all around. There is a small sliver of light coming from under the door at the top of the stairs. There are a bunch of moving boxes scattered all around the basement. In the far right corner of the basement there is a washing machine, dryer and a sink. Next to the sink is a shelf of tools. There is the basement door south of the basement.

You can see a basement door, a washing machine, Tools, Sink and Frank here.

>ask mike about breakfast
Here I brought you your breakfast. I am going to work now. Behave yourself.

>i
You are carrying:
  Breakfast

>open dryer
As you open the dryer, a loud squeek comes from the hinge of the dryer door. You freeze in fear, just in case he heard and comes to check on you. After a couple of minutes has passed, you continue searching the dryer. Using the light from inside the dryer you examine every inch of the inside. Still nothing, but as you look down as you were about to take your head out of the dryer, you see something in the lint trap. As you take out the filter, a rusty key drops to the floor.

You open the dryer, revealing a rusty key.

>take key
Taken.

>unlock door with key
You unlock the basement door.

>s
(first opening the basement door)

Staircase
You can see a basement door here.

>s
living room
There is an LG flatscreen TV on the pale wall. Under the TV is a cable box that sits on a wooden shelf. The windows on either sides of the TV are covered with heavy black drapes. A pretty large brown sofa about seven feet long is facing the TV. There is a glass coffee table on infront of the sofa.

>s
Stairs
Stairs that lead to the second level.

>s
Hallway
There are pictures of him and the animals he killed are across the wall, like some trophy hall.

You can see Bedroom door here.

>n
Stairs
Stairs that lead to the second level.

>n
living room
There is an LG flatscreen TV on the pale wall. Under the TV is a cable box that sits on a wooden shelf. The windows on either sides of the TV are covered with heavy black drapes. A pretty large brown sofa about seven feet long is facing the TV. There is a glass coffee table on infront of the sofa.

>e
kitchen
A typical kitchen. A generic refrigerator with a sink to the left of it. A counter to the left of the sink and to the right of the refrigerator. Notes stuck to the refrigerator by magnets. Wood cabinets surround the kitchen. In the back right corner of the kitchen is a door that leads to the yard.

There are notes on the refrigerator. Maybe you should examine them.

On Refrigerator is Notes.

>x notes
0222. Seems like an important code of somesort.

* * *

>look
Basement
Its dark all around you. There is a small sliver of light coming from under the door at the top of the stairs.

>w
You can't go that way.

>e
You can't go that way.

>n
You can't go that way.

>s
staircase

>s
Living room
There is an LG flatscreen TV on the pale wall. Under the TV is a cable box that sits on a wooden shelf. The windows on either sides of the TV are covered with heavy black drapes. A pretty large brown sofa about seven feet long is facing the TV. There is a glass coffee table on infront of the sofa.

>e
Kitchen
You can see Backdoor here.

>exit backddor
I only understood you as far as wanting to exit.

>exit backdoor
I only understood you as far as wanting to exit.

* * *

>open dryer
You continue searching the dryer. Using the light from inside the dryer you examine every inch of the inside. Still nothing, but as you look down as you were about to take your head out of the dryer, you see something in the lint trap. As you take out the filter, a rusty key drops to the floor.

You open the dryer, revealing a rusty key.

>take key
Taken.

>open door with key
You unlock the basement door.

>s
(first opening the basement door)

Staircase
Simple wood staircase leading from the basement to the living room. The living room is above the staircase. Walk up to get to the living room.

You can see a basement door here.

>u
living room
There is an LG flatscreen TV on the pale wall. Under the TV is a cable box that sits on a wooden shelf. The windows on either sides of the TV are covered with heavy black drapes. A pretty large brown sofa about seven feet long is facing the TV. There is a glass coffee table on infront of the sofa.

You can see Sofa here.

>u
Stairs
Stairs that lead to the second level. Nice dark wood stairs.

>s
Hallway
There are new picture frames on the wall. They have the sample pictures still in them, like when you buy a brand new picture frame. You can tell the items in this house is new.

You can see Bedroom door here.

>e
Utility closet
Inside the closet there are shelves in every direction. On the shelves to your left there are bottles of bleach, laundry detergents, and a box of dryer sheets. On the shelves straight in front of you there are spare light bulbs, and batteries. Under the shelf in front of you there is a large Matco toolbox. On the shelf to your right there are rolls of toilet paper, rolls of Bounty, and boxes of tissues.

>x toolbox
A large, chest high red toolbox made of military grade steel. There seems to be something inside the toolbox.

>open toolbox
You open Matco toolbox, revealing Yellow key.

>take yellow key
Taken.

>w
Hallway
There are new picture frames on the wall. They have the sample pictures still in them, like when you buy a brand new picture frame. You can tell the items in this house is new.

You can see Bedroom door here.

>w
(first opening Bedroom door)
It seems to be locked.

>open door with yellow key
You unlock Bedroom door.

>w
(first opening Bedroom door)

Bedroom
There is a desk in the corner of the room under a window that has a black curtain covering it. Papers are stacked high all over the desk. There is a bed adjacent to the desk. Blanket and sheets are unmade and scatter from the bed to the ground. There is something shining that you see under the desk, it looks like a safe.

You can see Bedroom door and Frank here.

>e
Hallway
There are new picture frames on the wall. They have the sample pictures still in them, like when you buy a brand new picture frame. You can tell the items in this house is new.

You can see Bedroom door here.

>e
Utility closet
Inside the closet there are shelves in every direction. On the shelves to your left there are bottles of bleach, laundry detergents, and a box of dryer sheets. On the shelves straight in front of you there are spare light bulbs, and batteries. Under the shelf in front of you there is a large Matco toolbox. On the shelf to your right there are rolls of toilet paper, rolls of Bounty, and boxes of tissues.

>x bleach
Just a regular bottle of bleach used for towels. Got to find something to open up the bedroom door! Don't try and drink it.

>drink bleach
After drinking the "bleach" you realize that it is just water, a worker of the breakout house comes to get you and tells you, "Because you drank the bleach you lose. Come by another time."

    *** You died from drinking bleach. You lose. ***

Would you like to RESTART, RESTORE a saved game, QUIT or UNDO the last command?

>restart
You and your friend Frank wanted to try the new breakout game in Waikiki . This breakout game is not like anyother though because it is not a room that you are trying to breakout from, it is a house!. You and Frank had reserved a day two months in advance to try the new breakout house. You and Frank get blindfolded and get placed in the basement, where you will begin your breakout.

Breakout
An Interactive Fiction by Duke Shimabukuro
Release 1 / Serial number 170227 / Inform 7 build 6M62 (I6/v6.33 lib 6/12N) SD

Basement
It's dark all around. There is a small sliver of light coming from under the door at the top of the stairs. There are a bunch of moving boxes scattered all around the basement. In the far right corner of the basement there is a washing machine, dryer and a sink. Next to the sink is a shelf of tools. There is the basement door south of the basement.

You can see a basement door, a washing machine, Tools, Sink and Frank here.

>open dryer
You continue searching the dryer. Using the light from inside the dryer you examine every inch of the inside. Still nothing, but as you look down as you were about to take your head out of the dryer, you see something in the lint trap. As you take out the filter, a rusty key drops to the floor.

You open the dryer, revealing a rusty key.

* * *

>take key
Taken.

>open door
It seems to be locked.

>unlock door with key
You unlock the basement door.

>s
(first opening the basement door)

Staircase
Simple wood staircase leading from the basement to the living room. The living room is above the staircase. Walk up to get to the living room.

You can see a basement door here.

>u
living room
There is an LG flatscreen TV on the pale wall. Under the TV is a cable box that sits on a wooden shelf. The windows on either sides of the TV are covered with heavy black drapes. A pretty large brown sofa about seven feet long is facing the TV. There is a glass coffee table on infront of the sofa.

>e
kitchen
A typical kitchen. A generic refrigerator with a sink to the left of it. A counter to the left of the sink and to the right of the refrigerator. Notes stuck to the refrigerator by magnets. Wood cabinets surround the kitchen. In the back right corner of the kitchen is a door that leads to the yard.

There are notes on the refrigerator.

On Refrigerator is Notes.

You can also see Frank and a backdoor here.

>x notes
0222. Seems like an important code of somesort.

>talk to frank
"Dude, it's pretty dark." you said casually. 

"We have to find some source of light so that we can look around the basement better." he replies.

>spin dial to 0222
You can't see any such thing.

>x safe
You can't see any such thing.

>s
You can't go that way.

* * *

>w
living room
There is an LG flatscreen TV on the pale wall. Under the TV is a cable box that sits on a wooden shelf. The windows on either sides of the TV are covered with heavy black drapes. A pretty large brown sofa about seven feet long is facing the TV. There is a glass coffee table on infront of the sofa.

>e
kitchen
A typical kitchen. A generic refrigerator with a sink to the left of it. A counter to the left of the sink and to the right of the refrigerator. Notes stuck to the refrigerator by magnets. Wood cabinets surround the kitchen. In the back right corner of the kitchen is a door that leads to the yard.

There are notes on the refrigerator.

On Refrigerator is Notes.

You can also see Frank and a backdoor here.

>talk to frank
"Dude, it's pretty dark." you said casually. 

"We have to find some source of light so that we can look around the basement better." he replies.

>g
"Dude, it's pretty dark." you said casually. 

"We have to find some source of light so that we can look around the basement better." he replies.

>s
You can't go that way.

>w
living room
There is an LG flatscreen TV on the pale wall. Under the TV is a cable box that sits on a wooden shelf. The windows on either sides of the TV are covered with heavy black drapes. A pretty large brown sofa about seven feet long is facing the TV. There is a glass coffee table on infront of the sofa.

>s
You can't go that way.

>u
Stairs
Stairs that lead to the second level. Nice dark wood stairs.

>u
You can't go that way.

>s
Hallway
There are new picture frames on the wall. They have the sample pictures still in them, like when you buy a brand new picture frame. You can tell the items in this house is new.

You can see Bedroom door here.

>w
(first opening Bedroom door)
It seems to be locked.

>s
You can't go that way.

>e
Utility closet
Inside the closet there are shelves in every direction. On the shelves to your left there are bottles of bleach, laundry detergents, and a box of dryer sheets. On the shelves straight in front of you there are spare light bulbs, and batteries. Under the shelf in front of you there is a large Matco toolbox. On the shelf to your right there are rolls of toilet paper, rolls of Bounty, and boxes of tissues.

>open toolbox
You open Matco toolbox, revealing Yellow key.

* * *

>w
(first opening Bedroom door)
It seems to be locked.

>unlock door with yellow key
You unlock Bedroom door.

>w
(first opening Bedroom door)

Bedroom
There is a desk in the corner of the room under a window that has a black curtain covering it. Papers are stacked high all over the desk. There is a bed adjacent to the desk. Blanket and sheets are unmade and scatter from the bed to the ground. There is something shining that you see under the desk, it looks like a safe.

You can see Bedroom door and Frank here.

>x safe
A heavy looking steel safe. There seems to be a dial on the front. There are instructions still on the safe. It reads "To unlock safe say spin dial to whatever your four digit password is." For example say "spin dial to 1122"

>spin dial to 0222
Clonk! and the safe door swings slowly open, revealing Red key.

>take red key
Taken.

>e
Hallway
There are new picture frames on the wall. They have the sample pictures still in them, like when you buy a brand new picture frame. You can tell the items in this house is new.

You can see Bedroom door here.

>s
You can't go that way.

>n
Stairs
Stairs that lead to the second level. Nice dark wood stairs.

>d
living room
There is an LG flatscreen TV on the pale wall. Under the TV is a cable box that sits on a wooden shelf. The windows on either sides of the TV are covered with heavy black drapes. A pretty large brown sofa about seven feet long is facing the TV. There is a glass coffee table on infront of the sofa.

>e
kitchen
A typical kitchen. A generic refrigerator with a sink to the left of it. A counter to the left of the sink and to the right of the refrigerator. Notes stuck to the refrigerator by magnets. Wood cabinets surround the kitchen. In the back right corner of the kitchen is a door that leads to the yard.

There are notes on the refrigerator.

On Refrigerator is Notes.

You can also see a backdoor here.

>unlock door with red key
You unlock the backdoor.

>e
    *** After entering the yard of the house, you are greeted by one of the workers. She congradulates you and Frank on escaping the house withing an hour and a half. You win! ***

Would you like to RESTART, RESTORE a saved game, QUIT or UNDO the last command?

>restart
You and your friend Frank wanted to try the new breakout game in Waikiki . This breakout game is not like anyother though because it is not a room that you are trying to breakout from, it is a house!. You and Frank had reserved a day two months in advance to try the new breakout house. You and Frank get blindfolded and get placed in the basement, where you will begin your breakout.

Breakout
An Interactive Fiction by Duke Shimabukuro
Release 1 / Serial number 170227 / Inform 7 build 6M62 (I6/v6.33 lib 6/12N) SD

Basement
It's dark all around. There is a small sliver of light coming from under the door at the top of the stairs. There are a bunch of moving boxes scattered all around the basement. In the far right corner of the basement there is a washing machine, dryer and a sink. Next to the sink is a shelf of tools. There is the basement door south of the basement.

You can see a basement door, a washing machine, Tools, Sink and Frank here.

>x washing machine
As you feel around the washing machine, you feel a cylindrical object, possibly a flashlight.

>take flashlight
As you turn on the flashlight, you see no signs of a key anywhere. You look high and low, and still can't find anything. It wouldn't be in the dryer, or would it?

>x dryer
A rusty dryer. Nothing too much about it. Maybe there is something in it.

>open dryer
You continue searching the dryer. Using the light from inside the dryer you examine every inch of the inside. Still nothing, but as you look down as you were about to take your head out of the dryer, you see something in the lint trap. As you take out the filter, a rusty key drops to the floor.

You open the dryer, revealing a rusty key.

>take rusty key
Taken.

>x tools
A bag of screwdrivers, hammers, and measuring tapes. Remember, you cant break anything in the house. Nothing usefull is here.

>take tools
Taken.

>sink
That's not a verb I recognise.

>x sink
A durable plastic workman sink. Nothing special about it other than if you wanted to wash your hands, but that is not important right now.

>take sink
That's fixed in place.

>take washing machine
That's fixed in place.

>talk to frank
"Dude, it's pretty dark." you said casually. 

"We have to find some source of light so that we can look around the basement better." he replies.

>s
(first opening the basement door)
It seems to be locked.

>unlock door with rusty key
You unlock the basement door.

>s
(first opening the basement door)

Staircase
Simple wood staircase leading from the basement to the living room. The living room is above the staircase. Walk up to get to the living room.

You can see a basement door here.

* * *

>u
living room
There is an LG flatscreen TV on the pale wall. Under the TV is a cable box that sits on a wooden shelf. The windows on either sides of the TV are covered with heavy black drapes. A pretty large brown sofa about seven feet long is facing the TV. There is a glass coffee table on infront of the sofa.

>take tv
That's hardly portable.

>x cable box
an ordinary cable box. Nothing important here.

>x window
You can't see any such thing.

>sit on sofa
That's not something you can sit down on.

>x sofa
A large brown sofa. Looks pretty comfy though.

>x table
You can't see any such thing.

>x glass coffee table
You can't see any such thing.

>w
Bathroom
Nothing to special here. Just a typical bathroom. Two towels hanging on the rack, one toothbrush in the toothbrush holder with a tube of toothpaste on the counter.

>take towls
You can't see any such thing.

>take towels
Taken.

>x toothbrush
You can't see any such thing.

>x toothpaste
Crest whitening toothpaste, pretty cool but it serves no use for us.

>take toothpaste
Taken.

>e
living room
There is an LG flatscreen TV on the pale wall. Under the TV is a cable box that sits on a wooden shelf. The windows on either sides of the TV are covered with heavy black drapes. A pretty large brown sofa about seven feet long is facing the TV. There is a glass coffee table on infront of the sofa.

>w
Bathroom
Nothing to special here. Just a typical bathroom. Two towels hanging on the rack, one toothbrush in the toothbrush holder with a tube of toothpaste on the counter.

>w
You can't go that way.

>e
living room
There is an LG flatscreen TV on the pale wall. Under the TV is a cable box that sits on a wooden shelf. The windows on either sides of the TV are covered with heavy black drapes. A pretty large brown sofa about seven feet long is facing the TV. There is a glass coffee table on infront of the sofa.

>e
kitchen
A typical kitchen. A generic refrigerator with a sink to the left of it. A counter to the left of the sink and to the right of the refrigerator. Notes stuck to the refrigerator by magnets. Wood cabinets surround the kitchen. In the back right corner of the kitchen is a door that leads to the yard.

There are notes on the refrigerator.

On Refrigerator is Notes.

You can also see Frank and a backdoor here.

>x fridge
You can't see any such thing.

>x frige
You can't see any such thing.

>x refrigerator
On Refrigerator is Notes.

>x notes
0222. Seems like an important code of somesort.

>x magnets
You can't see any such thing.

>x wood cabinets
You can't see any such thing.

>x cabinets
Wood cabinets that wrap around the kitchen. They look pretty decent.

>take cabinets
Taken.

>w
living room
There is an LG flatscreen TV on the pale wall. Under the TV is a cable box that sits on a wooden shelf. The windows on either sides of the TV are covered with heavy black drapes. A pretty large brown sofa about seven feet long is facing the TV. There is a glass coffee table on infront of the sofa.

* * *

>talk to frank
"Dude, it's pretty dark." you said casually. 

"We have to find some source of light so that we can look around the basement better." he replies.

>ask frank about backdoor
There is no reply.

* * *

>w
living room
There is an LG flatscreen TV on the pale wall. Under the TV is a cable box that sits on a wooden shelf. The windows on either sides of the TV are covered with heavy black drapes. A pretty large brown sofa about seven feet long is facing the TV. There is a glass coffee table on infront of the sofa.

>u
Stairs
Stairs that lead to the second level. Nice dark wood stairs.

* * *

>x bleach
Just a regular bottle of bleach used for towels. Got to find something to open up the bedroom door! Don't try and drink it.

>x laundy detergents
You can't see any such thing.

>x box of dryer sheets
Just an ordinary box of dryer sheets. Need to find something that will open the door to the bedroom.

>take light bubls
I only understood you as far as wanting to take Light bulbs.

>take light bulbs
Taken.

>x batteries
Just a pack of duracell batteries. Got to find something that will open the bedroom door.

>x matco toolbox
A large, chest high red toolbox made of military grade steel. There seems to be something inside the toolbox.

>open matco toolbox
You open Matco toolbox, revealing Yellow key.

>take yellow key
Taken.

* * *

>w
Hallway
There are new picture frames on the wall. They have the sample pictures still in them, like when you buy a brand new picture frame. You can tell the items in this house is new.

You can see Bedroom door here.

>unlock bedroom
What do you want to unlock Bedroom door with?

>yellow key
You unlock Bedroom door.

>e
Utility closet
Inside the closet there are shelves in every direction. On the shelves to your left there are bottles of bleach, laundry detergents, and a box of dryer sheets. On the shelves straight in front of you there are spare light bulbs, and batteries. Under the shelf in front of you there is a large Matco toolbox. On the shelf to your right there are rolls of toilet paper, rolls of Bounty, and boxes of tissues.

>w
Hallway
There are new picture frames on the wall. They have the sample pictures still in them, like when you buy a brand new picture frame. You can tell the items in this house is new.

You can see Bedroom door here.

>w
(first opening Bedroom door)

Bedroom
There is a desk in the corner of the room under a window that has a black curtain covering it. Papers are stacked high all over the desk. There is a bed adjacent to the desk. Blanket and sheets are unmade and scatter from the bed to the ground. There is something shining that you see under the desk, it looks like a safe.

You can see Bedroom door and Frank here.

>x desck
You can't see any such thing.

>x desk
A wood desk that seems to be empty. However there seems to be a safe beneath it.

>x safe
A heavy looking steel safe. There seems to be a dial on the front. There are instructions still on the safe. It reads "To unlock safe say spin dial to whatever your four digit password is." For example say "spin dial to 1122"

* * *

>e
Hallway
There are new picture frames on the wall. They have the sample pictures still in them, like when you buy a brand new picture frame. You can tell the items in this house is new.

You can see Bedroom door here.

>n
Stairs
Stairs that lead to the second level. Nice dark wood stairs.

* * *

>e
kitchen
A typical kitchen. A generic refrigerator with a sink to the left of it. A counter to the left of the sink and to the right of the refrigerator. Notes stuck to the refrigerator by magnets. Wood cabinets surround the kitchen. In the back right corner of the kitchen is a door that leads to the yard.

There are notes on the refrigerator.

On Refrigerator is Notes.

You can also see a backdoor here.

>unlock backdoor
What do you want to unlock the backdoor with?

>red key
You unlock the backdoor.

>e
    *** After entering the yard of the house, you are greeted by one of the workers. She congradulates you and Frank on escaping the house withing an hour and a half. You win! ***

Would you like to RESTART, RESTORE a saved game, QUIT or UNDO the last command?

>undo
The use of "undo" is forbidden in this story.

Would you like to RESTART, RESTORE a saved game, QUIT or UNDO the last command?

>e
Please give one of the answers above.

Would you like to RESTART, RESTORE a saved game, QUIT or UNDO the last command?

* * *

>take key
Taken.

>unlock door
(with the rusty key)
You unlock the basement door.

>s
(first opening the basement door)

Staircase
You can see a basement door here.

* * *

>s
Stairs
Stairs that lead to the second level.

>s
Hallway
There are pictures of him and the animals he killed are across the wall, like some trophy hall.

>e
Utility closet
Inside the closet there are shelves in every direction. On the shelves to your left there are bottles of bleach, laundry detergents, and a box of dryer sheets. On the shelves straight in front of you there are spare light bulbs, and batteries. Under the shelf in front of you there is a large Matco toolbox. On the shelf to your right there are rolls of toilet paper, paper towels, and boxes of tissues.

>w
Hallway
There are pictures of him and the animals he killed are across the wall, like some trophy hall.

>w
Bedroom
There is a desk in the corner of the room under a window that has a black curtain covering it. Papers are stacked high all over the desk. There is a bed adjacent to the desk. Blanket and sheets are unmade and scatter from the bed to the ground. There is something shining that you see under the desk.

>e
Hallway
There are pictures of him and the animals he killed are across the wall, like some trophy hall.

>s
You can't go that way.

* * *

>s
Hallway
There are pictures of him and the animals he killed are across the wall, like some trophy hall.

>w
Bedroom
There is a desk in the corner of the room under a window that has a black curtain covering it. Papers are stacked high all over the desk. There is a bed adjacent to the desk. Blanket and sheets are unmade and scatter from the bed to the ground. There is something shining that you see under the desk.

I beg your pardon?

>e
Hallway
There are pictures of him and the animals he killed are across the wall, like some trophy hall.

>e
Utility closet
Inside the closet there are shelves in every direction. On the shelves to your left there are bottles of bleach, laundry detergents, and a box of dryer sheets. On the shelves straight in front of you there are spare light bulbs, and batteries. Under the shelf in front of you there is a large Matco toolbox. On the shelf to your right there are rolls of toilet paper, paper towels, and boxes of tissues.

>drink bleach
You fool. I told you not to drink the bleach. Now look at you, all dead and now you have to restart.

    *** You died from drinking bleach. You lose. ***

Would you like to RESTART, RESTORE a saved game, QUIT or UNDO the last command?

>drink bleach
Please give one of the answers above.

Would you like to RESTART, RESTORE a saved game, QUIT or UNDO the last command?

>eat bleach
Please give one of the answers above.

Would you like to RESTART, RESTORE a saved game, QUIT or UNDO the last command?

>drink bleach
Please give one of the answers above.

Would you like to RESTART, RESTORE a saved game, QUIT or UNDO the last command?

* * *

>e
Utility closet
Inside the closet there are shelves in every direction. On the shelves to your left there are bottles of bleach, laundry detergents, and a box of dryer sheets. On the shelves straight in front of you there are spare light bulbs, and batteries. Under the shelf in front of you there is a large Matco toolbox. On the shelf to your right there are rolls of toilet paper, paper towels, and boxes of tissues.

>x bleach
Just a regular bottle of bleach used for towels. Got to find something to open up the bedroom door! Don't try and drink it.

>drink bleach
You fool. I told you not to drink the bleach. Now look at you, all dead and now you have to restart.

    *** You died from drinking bleach. You lose. ***

Would you like to RESTART, RESTORE a saved game, QUIT or UNDO the last command?

>restore
Restore failed.

Would you like to RESTART, RESTORE a saved game, QUIT or UNDO the last command?

>undo
The use of "undo" is forbidden in this story.

Would you like to RESTART, RESTORE a saved game, QUIT or UNDO the last command?

>undo
The use of "undo" is forbidden in this story.

Would you like to RESTART, RESTORE a saved game, QUIT or UNDO the last command?

>s
Please give one of the answers above.

Would you like to RESTART, RESTORE a saved game, QUIT or UNDO the last command?

>e
Please give one of the answers above.

Would you like to RESTART, RESTORE a saved game, QUIT or UNDO the last command?

>w
Please give one of the answers above.

Would you like to RESTART, RESTORE a saved game, QUIT or UNDO the last command?

>e
Please give one of the answers above.

Would you like to RESTART, RESTORE a saved game, QUIT or UNDO the last command?

>restore
Restore failed.

Would you like to RESTART, RESTORE a saved game, QUIT or UNDO the last command?

* * *

>s
living room
There is an LG flatscreen TV on the pale wall. Under the TV is a cable box that sits on a wooden shelf. The windows on either sides of the TV are covered with heavy black drapes. A pretty large brown sofa about seven feet long is facing the TV. There is a glass coffee table on infront of the sofa.

>w
You can't go that way.

* * *

>e
You can't go that way.

>n
Basement
Its dark all around you. There is a small sliver of light coming from under the door at the top of the stairs. There are a bunch of moving boxes scattered all around the basement. In the far right corner of the basement there is a washing machine, dryer and a sink. Next to the sink is a shelf of tools.

You can see a basement door and a washing machine here.

* * *

>s
(first opening the basement door)

Staircase
You can see a basement door here.

>i
You are carrying:
  a rusty key

* * *

>s
Hallway
There are pictures of him and the animals he killed are across the wall, like some trophy hall.

You can see Bedroom door here.

>e
Utility closet
Inside the closet there are shelves in every direction. On the shelves to your left there are bottles of bleach, laundry detergents, and a box of dryer sheets. On the shelves straight in front of you there are spare light bulbs, and batteries. Under the shelf in front of you there is a large Matco toolbox. On the shelf to your right there are rolls of toilet paper, paper towels, and boxes of tissues.

>open toolbox
You open Matco toolbox, revealing Yellow key.

* * *

>take yellow key
Taken.

>w
Hallway
There are pictures of him and the animals he killed are across the wall, like some trophy hall.

You can see Bedroom door here.

>w
(first opening Bedroom door)
It seems to be locked.

* * *

>unlock door with yellow key
You unlock Bedroom door.

>w
(first opening Bedroom door)

Bedroom
There is a desk in the corner of the room under a window that has a black curtain covering it. Papers are stacked high all over the desk. There is a bed adjacent to the desk. Blanket and sheets are unmade and scatter from the bed to the ground. There is something shining that you see under the desk.

You can see Bedroom door here.

>x safe
A heavy looking steel safe. There seems to be a dial on the front. There are instructions still on the safe. It reads "To unlock safe say spin dial to whatever your four digit password is." For example say "spin dial to 1122"

* * *

>take red key
Taken.

>e
Hallway
There are pictures of him and the animals he killed are across the wall, like some trophy hall.

You can see Bedroom door here.

>n
Stairs
Stairs that lead to the second level.

* * *

>n
living room
There is an LG flatscreen TV on the pale wall. Under the TV is a cable box that sits on a wooden shelf. The windows on either sides of the TV are covered with heavy black drapes. A pretty large brown sofa about seven feet long is facing the TV. There is a glass coffee table on infront of the sofa.

>e
kitchen
A typical kitchen. A generic refrigerator with a sink to the left of it. A counter to the left of the sink and to the right of the refrigerator. Notes stuck to the refrigerator by magnets. Wood cabinets surround the kitchen. In the back right corner of the kitchen is a door that leads to the yard.

>e
You can't go that way.

>e
You can't go that way.

>w
living room
There is an LG flatscreen TV on the pale wall. Under the TV is a cable box that sits on a wooden shelf. The windows on either sides of the TV are covered with heavy black drapes. A pretty large brown sofa about seven feet long is facing the TV. There is a glass coffee table on infront of the sofa.

>e
kitchen
A typical kitchen. A generic refrigerator with a sink to the left of it. A counter to the left of the sink and to the right of the refrigerator. Notes stuck to the refrigerator by magnets. Wood cabinets surround the kitchen. In the back right corner of the kitchen is a door that leads to the yard.

* * *

>e
You can't go that way.

>e\
That's not a verb I recognise.

>e
You can't go that way.

>unlock door with red key
You unlock the backdoor.

>e
You can't go that way.

* * *

>e
Utility closet
Inside the closet there are shelves in every direction. On the shelves to your left there are bottles of bleach, laundry detergents, and a box of dryer sheets. On the shelves straight in front of you there are spare light bulbs, and batteries. Under the shelf in front of you there is a large Matco toolbox. On the shelf to your right there are rolls of toilet paper, paper towels, and boxes of tissues.

>take red key
You can't see any such thing.

>open matco toolbox
You open Matco toolbox, revealing Yellow key.

>Open toolbox
That's already open.

>Open Matco toolbox
That's already open.

>open toolboc
You can't see any such thing.

>x toolbox
A large, chest high red toolbox made of military grade steel. There seems to be something inside the toolbox.

In Matco toolbox is Yellow key.

>take yellow key
Taken.

* * *

>x safe
A heavy looking steel safe. There seems to be a dial on the front. There are instructions still on the safe. It reads "To unlock safe say spin dial to whatever your four digit password is." For example say "spin dial to 1122"

>use dial
That's not a verb I recognise.

>open safe
It seems to be locked.

>open safe / spin safe to 0222 / open safe
I only understood you as far as wanting to open Safe.

>spin dail to 0222
You can't see any such thing.

>spin dial to 0222
Clonk! and the safe door swings slowly open, revealing Red key.

* * *

>e
kitchen
A typical kitchen. A generic refrigerator with a sink to the left of it. A counter to the left of the sink and to the right of the refrigerator. Notes stuck to the refrigerator by magnets. Wood cabinets surround the kitchen. In the back right corner of the kitchen is a door that leads to the yard.

>x door
This door leads to the yard. I could probably hop the fence and escape from there.

>x backdoor
This door leads to the yard. I could probably hop the fence and escape from there.

>open door
It seems to be locked.

>unlock door with red key
You unlock the backdoor.

>e
you unlock door and exit
Yard
Oh the smell of fresh air, the cool breeze rushing passed you, the trees swaying in the wind. The feelings overwhelm you. You start to break down, but it is not over yet so you gather yourself together and climb over the fence. As you stumble into the street, some strangers notice you and come to help you and they began to call the cops. It is over, the fight is over, you are in safety now.

    *** you win ***

Would you like to RESTART, RESTORE a saved game, QUIT or UNDO the last command?

>open door
Please give one of the answers above.

Would you like to RESTART, RESTORE a saved game, QUIT or UNDO the last command?

>e
Please give one of the answers above.

Would you like to RESTART, RESTORE a saved game, QUIT or UNDO the last command?

>e
Please give one of the answers above.

Would you like to RESTART, RESTORE a saved game, QUIT or UNDO the last command?

>s
Please give one of the answers above.

Would you like to RESTART, RESTORE a saved game, QUIT or UNDO the last command?

>n
Please give one of the answers above.

Would you like to RESTART, RESTORE a saved game, QUIT or UNDO the last command?

>e
Please give one of the answers above.

Would you like to RESTART, RESTORE a saved game, QUIT or UNDO the last command?

>unlock backdoor
Please give one of the answers above.

Would you like to RESTART, RESTORE a saved game, QUIT or UNDO the last command?

>red key
Please give one of the answers above.

Would you like to RESTART, RESTORE a saved game, QUIT or UNDO the last command?

>e
Please give one of the answers above.

Would you like to RESTART, RESTORE a saved game, QUIT or UNDO the last command?

>go to yard
Please give one of the answers above.

Would you like to RESTART, RESTORE a saved game, QUIT or UNDO the last command?

>e
Please give one of the answers above.

Would you like to RESTART, RESTORE a saved game, QUIT or UNDO the last command?

>open door
Please give one of the answers above.

Would you like to RESTART, RESTORE a saved game, QUIT or UNDO the last command?

* * *

>e
Please give one of the answers above.

Would you like to RESTART, RESTORE a saved game, QUIT or UNDO the last command?

>walk through door
Please give one of the answers above.

Would you like to RESTART, RESTORE a saved game, QUIT or UNDO the last command?

>w
Please give one of the answers above.

Would you like to RESTART, RESTORE a saved game, QUIT or UNDO the last command?

>s
Please give one of the answers above.

Would you like to RESTART, RESTORE a saved game, QUIT or UNDO the last command?

Please give one of the answers above.

Would you like to RESTART, RESTORE a saved game, QUIT or UNDO the last command?

>n
Please give one of the answers above.

Would you like to RESTART, RESTORE a saved game, QUIT or UNDO the last command?

* * *

>e
Please give one of the answers above.

Would you like to RESTART, RESTORE a saved game, QUIT or UNDO the last command?

Please give one of the answers above.

Would you like to RESTART, RESTORE a saved game, QUIT or UNDO the last command?

>w
Please give one of the answers above.

Would you like to RESTART, RESTORE a saved game, QUIT or UNDO the last command?

>d
Please give one of the answers above.

Would you like to RESTART, RESTORE a saved game, QUIT or UNDO the last command?

>s
Please give one of the answers above.

Would you like to RESTART, RESTORE a saved game, QUIT or UNDO the last command?

>s
Please give one of the answers above.

Would you like to RESTART, RESTORE a saved game, QUIT or UNDO the last command?

>w
Please give one of the answers above.

Would you like to RESTART, RESTORE a saved game, QUIT or UNDO the last command?

>open door
Please give one of the answers above.

Would you like to RESTART, RESTORE a saved game, QUIT or UNDO the last command?

>w
Please give one of the answers above.

Would you like to RESTART, RESTORE a saved game, QUIT or UNDO the last command?

>n
Please give one of the answers above.

Would you like to RESTART, RESTORE a saved game, QUIT or UNDO the last command?

>n
Please give one of the answers above.

Would you like to RESTART, RESTORE a saved game, QUIT or UNDO the last command?

* * *

>e
Please give one of the answers above.

Would you like to RESTART, RESTORE a saved game, QUIT or UNDO the last command?

>n
Please give one of the answers above.

Would you like to RESTART, RESTORE a saved game, QUIT or UNDO the last command?

* * *

>e
Please give one of the answers above.

Would you like to RESTART, RESTORE a saved game, QUIT or UNDO the last command?

>unlock door with key
Please give one of the answers above.

Would you like to RESTART, RESTORE a saved game, QUIT or UNDO the last command?

>red key
Please give one of the answers above.

Would you like to RESTART, RESTORE a saved game, QUIT or UNDO the last command?

* * *

>e
Please give one of the answers above.

Would you like to RESTART, RESTORE a saved game, QUIT or UNDO the last command?

>go through backdoor
Please give one of the answers above.

Would you like to RESTART, RESTORE a saved game, QUIT or UNDO the last command?

* * *

>x bleach
Just a regular bottle of bleach used for towels. Got to find something to open up the bedroom door! Don't try and drink it.

>drink bleach
You fool! I told you not to drink the bleach. Now look at you, all dead and now you have to restart.

    *** You died from drinking bleach. You lose. ***

Would you like to RESTART, RESTORE a saved game, QUIT or UNDO the last command?

>undo
The use of "undo" is forbidden in this story.

Would you like to RESTART, RESTORE a saved game, QUIT or UNDO the last command?

* * *

>s
(first opening the basement door)

Staircase
You can see a basement door here.

>x staircase
You can't see any such thing.

>u
You can't go that way.

>s
You can't go that way.

>x staircase
You can't see any such thing.

* * *

>take key
Taken.

>unlock door with rusty key
You unlock the basement door.

>s
(first opening the basement door)

saircase
You can see a basement door here.

>s
You can't go that way.

>n
Basement
Its dark all around you. There is a small sliver of light coming from under the door at the top of the stairs. There are a bunch of moving boxes scattered all around the basement. In the far right corner of the basement there is a washing machine, dryer and a sink. Next to the sink is a shelf of tools.

You can see a basement door and a washing machine here.

>s
saircase
You can see a basement door here.

>s
You can't go that way.

>s
You can't go that way.

>ss
That's not a verb I recognise.

>s
You can't go that way.

* * *

>s
(first opening the wood door)
It seems to be locked.

* * *

>take all
rusty key: Taken.
Flashlight: Taken.

>unlock door with rusty key
You unlock the basement door.

* * *

>s
(first opening the basement door)

saircase
You can see a basement door here.

>open door
That's already open.

>s
You can't go that way.

>x door
You see nothing special about the basement door.

I beg your pardon?

>e
You can't go that way.

>w
You can't go that way.

>s
You can't go that way.

* * *

>take flashlight
As you turn on the flashlight, you see no signs of a key anywhere. You look high and low, and still can't find anything. It wouldn't be in the dryer, or would it?

>take all
rusty key: Taken.

>unlock door
What do you want to unlock the basement door with?

>rusty key
You unlock the basement door.

>s
(first opening the basement door)

saircase
You can see a basement door here.

* * *

>s
You can't go that way.

>e
You can't go that way.

* * *

>n
Basement
Its dark all around you. There is a small sliver of light coming from under the door at the top of the stairs. There are a bunch of moving boxes scattered all around the basement. In the far right corner of the basement there is a washing machine, dryer and a sink. Next to the sink is a shelf of tools.

You can see a basement door and a washing machine here.

>n
You can't go that way.

>s
saircase
You can see a basement door here.

* * *

>take flashlight
As you turn on the flashlight, you see no signs of a key anywhere. You look high and low, and still can't find anything. It wouldn't be in the dryer, or would it?

>x dryer
You can't see any such thing.

>open dryer
You can't see any such thing.

I beg your pardon?

* * *

>open dryer
You can't see any such thing.

>take key
You can't see any such thing.

* * *

>take key
You can't see any such thing.

>n
You can't go that way.

>s
(first opening the basement door)
It seems to be locked.

>use key
That's not a verb I recognise.

>unlock door
(with the rusty key)
You unlock the basement door.

>s
(first opening the basement door)

saircase
You can see a basement door here.

* * *

>s
You can't go that way.

>n
Basement
Its dark all around you. There is a small sliver of light coming from under the door at the top of the stairs. There are a bunch of moving boxes scattered all around the basement. In the far right corner of the basement there is a washing machine, dryer and a sink. Next to the sink is a shelf of tools.

You can see a basement door and a washing machine (on which is Flashlight) here.

>s
saircase
You can see a basement door here.

I beg your pardon?

>s
You can't go that way.

I beg your pardon?

* * *

>take key
You can't see any such thing.

>open dryer
As you open the dryer, a loud squeek comes from the hinge of the dryer door. You freeze in fear, just in case he heard and comes to check on you. After a couple of minutes has passed, you continue searching the dryer. Using the light from inside the dryer you examine every inch of the inside. Still nothing, but as you look down as you were about to take your head out of the dryer, you see something in the lint trap. As you take out the filter, a rusty key drops to the floor.

You open the dryer, revealing a rusty key.

>take flashlihgt
You can't see any such thing.

>take flashlight
As you turn on the flashlight, you see no signs of a key anywhere. You look high and low, and still can't find anything. It wouldn't be in the dryer, or would it?

* * *

>s
You can't go that way.

>w
You can't go that way.

* * *

>e
You can't go that way.

>s
You can't go that way.

* * *

>talk to frank
"Dude, it's pretty dark." you said casually. 

"We have to find some source of light so that we can look around the basement better." he replies.

>open dryer
You continue searching the dryer. Using the light from inside the dryer you examine every inch of the inside. Still nothing, but as you look down as you were about to take your head out of the dryer, you see something in the lint trap. As you take out the filter, a rusty key drops to the floor.

You open the dryer, revealing a rusty key.

* * *

>take key
Taken.

>s
(first opening the basement door)
It seems to be locked.

>open door with key
You unlock the basement door.

* * *

>s
(first opening the basement door)

Staircase
Simple wood staircase leading from the basement to the living room. The living room is above the staircase. Walk up to get to the living room.

You can see a basement door here.

>u
living room
There is an LG flatscreen TV on the pale wall. Under the TV is a cable box that sits on a wooden shelf. The windows on either sides of the TV are covered with heavy black drapes. A pretty large brown sofa about seven feet long is facing the TV.

>e
Kitchen
A typical kitchen. A generic refrigerator with a kitchen sink to the left of it. A counter to the left of the kitchen sink and to the right of the refrigerator. Notes stuck to the refrigerator by magnets. Wood cabinets surround the kitchen. In the back right corner of the kitchen is a door that leads to the yard.

There are notes on the refrigerator.

On Refrigerator is Notes.

You can also see Frank, a backdoor and Counter here.

>talk to frank
"This kitchen is pretty cool, let's look around." you say enthusiastically. 

"Dude there is a bunch of cereal in these cabinets, to bad there is nothing in them. You see that door dude, I bet we can escape this house from there. We just have to find the key that will unlock it." he replies.

>g
"This kitchen is pretty cool, let's look around." you say enthusiastically. 

"Dude there is a bunch of cereal in these cabinets, to bad there is nothing in them. You see that door dude, I bet we can escape this house from there. We just have to find the key that will unlock it." he replies.

>w
living room
There is an LG flatscreen TV on the pale wall. Under the TV is a cable box that sits on a wooden shelf. The windows on either sides of the TV are covered with heavy black drapes. A pretty large brown sofa about seven feet long is facing the TV.

>e
Kitchen
A typical kitchen. A generic refrigerator with a kitchen sink to the left of it. A counter to the left of the kitchen sink and to the right of the refrigerator. Notes stuck to the refrigerator by magnets. Wood cabinets surround the kitchen. In the back right corner of the kitchen is a door that leads to the yard.

There are notes on the refrigerator.

On Refrigerator is Notes.

You can also see Frank, a backdoor and Counter here.

* * *

>talk to mike
That's not a verb I recognise.

>ask mike about breakfast
Here I brought you your breakfast.

>i
You are carrying:
  Breakfast

* * *

>x door
You see nothing special about the basement door.

>x washing machine
On the washing machine is Flashlight.

>take flashlight
Taken.

* * *

>x dryer
A rusty dryer. Nothing too much about it. Maybe there is something in it.

>x washer
As you feel around the washing machine, you feel a cylindrical object, possibly a flashlight.

>talk to mike
That's not a verb I recognise.

>ask mike about washer
You can't see any such thing.

>ask mike about washing machine
You can't see any such thing.

>take tools
Taken.

>x shelf
You can't see any such thing.

>x sink
A durable plastic workman sink. Nothing special about it other than if you wanted to wash your hands, but that is not important right now.

>x washing machine
As you feel around the washing machine, you feel a cylindrical object, possibly a flashlight.

* * *

>take flashlight
As you turn on the flashlight, you see no signs of a key anywhere. You look high and low, and still can't find anything. It wouldn't be in the dryer, or would it?

>open dryer
You continue searching the dryer. Using the light from inside the dryer you examine every inch of the inside. Still nothing, but as you look down as you were about to take your head out of the dryer, you see something in the lint trap. As you take out the filter, a rusty key drops to the floor.

You open the dryer, revealing a rusty key.

* * *

>take key
Taken.

>l
Basement
It's dark all around. There is a small sliver of light coming from under the door at the top of the stairs. There are a bunch of moving boxes scattered all around the basement. In the far right corner of the basement there is a washing machine, dryer and a sink. Next to the sink is a shelf of tools.

You can see a basement door, a washing machine, Sink and Frank here.

>x boxes
Just some boxes that has items like picture frames. Nothing important.

>open door
It seems to be locked.

>unlock door
What do you want to unlock the basement door with?

>up
You can't see any such thing.

>l
Basement
It's dark all around. There is a small sliver of light coming from under the door at the top of the stairs. There are a bunch of moving boxes scattered all around the basement. In the far right corner of the basement there is a washing machine, dryer and a sink. Next to the sink is a shelf of tools.

You can see a basement door, a washing machine, Sink and Frank here.

>n
You can't go that way.

>w
You can't go that way.

* * *

>e
You can't go that way.

>s
(first opening the basement door)
It seems to be locked.

>s
(first opening the basement door)
It seems to be locked.

>turn on tv
You can't see any such thing.

>turn on box
You can't see any such thing.

>sit on sofa
You can't see any such thing.

>x sofa
You can't see any such thing.

>x table
You can't see any such thing.

>x box
You can't see any such thing.

>x tv
You can't see any such thing.

>x TV
You can't see any such thing.

>open drapes
You can't see any such thing.

>n
You can't go that way.

* * *

>s
(first opening the basement door)
It seems to be locked.

>up
You can't go that way.

>s
(first opening the basement door)
It seems to be locked.

>x pictures
You can't see any such thing.

>open door
It seems to be locked.

* * *

>unlock door
What do you want to unlock the basement door with?

>s
You can't see any such thing.

>e
You can't go that way.

>take toolbox
You can't see any such thing.

>open toolbox
You can't see any such thing.

>take key
You already have that.

>take tissues
You can't see any such thing.

>tke towels
That's not a verb I recognise.

>take towels
You can't see any such thing.

>take light bulbs
You can't see any such thing.

>take batteries
You can't see any such thing.

>take all
Sink: Taken.

>take toilet paper
You can't see any such thing.

>take dryer sheets
I only understood you as far as wanting to take the dryer.

>take bleach
You can't see any such thing.

>take detergents
You can't see any such thing.

>i
You are carrying:
  Sink
  a rusty key
  Tools

>e
You can't go that way.

* * *

>w
You can't go that way.

>open door
It seems to be locked.

* * *

>unlock door
What do you want to unlock the basement door with?

>yellow
You can't see any such thing.

>e
You can't go that way.

* * *

>w
You can't go that way.

>w
You can't go that way.

>x desk
You can't see any such thing.

>x papers
You can't see any such thing.

>look under desk
You can't see any such thing.

>x shining
You can't see any such thing.

>look under desk
You can't see any such thing.

>x desk
You can't see any such thing.

>take sheets
You can't see any such thing.

>open curtain
You can't see any such thing.

>l
Basement
It's dark all around. There is a small sliver of light coming from under the door at the top of the stairs. There are a bunch of moving boxes scattered all around the basement. In the far right corner of the basement there is a washing machine, dryer and a sink. Next to the sink is a shelf of tools.

You can see a basement door, a washing machine and Frank here.

>e
You can't go that way.

* * *

>w
You can't go that way.

>s
(first opening the basement door)
It seems to be locked.

>n
You can't go that way.

>n
You can't go that way.

>under desk
That's not a verb I recognise.

>x safe
You can't see any such thing.

>spin dial to 1122
You can't see any such thing.

>i
You are carrying:
  Sink
  a rusty key
  Tools

>w
You can't go that way.

* * *

>n
You can't go that way.

>down
You can't go that way.

>e
You can't go that way.

* * *

>n
You can't go that way.

I beg your pardon?

I beg your pardon?

>s
(first opening the basement door)
It seems to be locked.

>e
You can't go that way.

* * *

>w
You can't go that way.

>n
You can't go that way.

>e
You can't go that way.

>take all
There are none at all available!

>x notes
You can't see any such thing.

>open backdoor
You can't see any such thing.

>unlock backdoor
You can't see any such thing.

>key
That's not a verb I recognise.

>yellow
That's not a verb I recognise.

>open refrigerator
You can't see any such thing.

>open cabinets
You can't see any such thing.

>e
You can't go that way.

I beg your pardon?

>n
You can't go that way.

* * *

>s
(first opening the basement door)
It seems to be locked.

>w
You can't go that way.

>x safe
You can't see any such thing.

>spin dial to 0222
You can't see any such thing.

>take key
You already have that.

>e
You can't go that way.

>open backdoor
You can't see any such thing.

>unloc bakdoor
That's not a verb I recognise.

>unlock backdoor
You can't see any such thing.

>red
That's not a verb I recognise.

>e
You can't go that way.

>undo
The use of "undo" is forbidden in this story.

>restart
Are you sure you want to restart?

>take flashlight
Please answer yes or no.

>yes
You and your friend Frank wanted to try the new breakout game in Waikiki . This breakout game is not like anyother though because it is not a room that you are trying to breakout from, it is a house!. You and Frank had reserved a day two months in advance to try the new breakout house. You and Frank get blindfolded and get placed in the basement, where you will begin your breakout.

Breakout
An Interactive Fiction by Duke Shimabukuro
Release 1 / Serial number 170227 / Inform 7 build 6M62 (I6/v6.33 lib 6/12N) SD

Basement
It's dark all around. There is a small sliver of light coming from under the door at the top of the stairs. There are a bunch of moving boxes scattered all around the basement. In the far right corner of the basement there is a washing machine, dryer and a sink. Next to the sink is a shelf of tools.

You can see a basement door, a washing machine, Tools, Sink and Frank here.

>talk to frank
That's not a verb I recognise.

* * *

>x mike
He is a tall white man with brown beard and brown hair. He is holding your breakfast, you should ask him about it.

>talk to mike
That's not a verb I recognise.

>take breakfast from mike
You can't see any such thing.

>take breakfast
You can't see any such thing.

>ask mike about breakfast
Here I brought you your breakfast. I am going to work now. Behave yourself.

* * *

>open door with key
You unlock the basement door.

>s
(first opening the basement door)

Staircase
You can see a basement door here.

* * *

>unlock door with yellow key
You unlock Bedroom door.

>x safe
You can't see any such thing.

>w
(first opening Bedroom door)

Bedroom
There is a desk in the corner of the room under a window that has a black curtain covering it. Papers are stacked high all over the desk. There is a bed adjacent to the desk. Blanket and sheets are unmade and scatter from the bed to the ground. There is something shining that you see under the desk.

You can see Bedroom door here.

* * *

>x safe
A heavy looking steel safe. There seems to be a dial on the front. There are instructions still on the safe. It reads "To unlock safe say spin dial to whatever your four digit password is." For example say "spin dial to 1122"

>w
You can't go that way.

>turn dial to 0222
I only understood you as far as wanting to turn Safe.

>spin dial to 0222
Clonk! and the safe door swings slowly open, revealing Red key.

* * *

>n
living room
There is an LG flatscreen TV on the pale wall. Under the TV is a cable box that sits on a wooden shelf. The windows on either sides of the TV are covered with heavy black drapes. A pretty large brown sofa about seven feet long is facing the TV. There is a glass coffee table on infront of the sofa.

>e
kitchen
A typical kitchen. A generic refrigerator with a sink to the left of it. A counter to the left of the sink and to the right of the refrigerator. Notes stuck to the refrigerator by magnets. Wood cabinets surround the kitchen. In the back right corner of the kitchen is a door that leads to the yard.

There are notes on the refrigerator. Maybe you should examine them.

On Refrigerator is Notes.

You can also see a backdoor here.

>x notes
0222. Seems like an important code of somesort.

>open door with red key
You unlock the backdoor.

>e
    *** Oh the smell of fresh air, the cool breeze rushing passed you, the trees swaying in the wind. The feelings overwhelm you. You start to break down, but it is not over yet so you gather yourself together and climb over the fence. As you stumble into the street, some strangers notice you and come to help you and they began to call the cops. It is over, the fight is over, you are in safety now. You escaped! ***

Would you like to RESTART, RESTORE a saved game, QUIT or UNDO the last command?

>w
Please give one of the answers above.

Would you like to RESTART, RESTORE a saved game, QUIT or UNDO the last command?

* * *

>x room
You can't see any such thing.

* * *

>x washing machine
As you feel around the washing machine, you feel a cylindrical object, possibly a flashlight.

* * *

>take flashlight
As you turn on the flashlight, you see no signs of a key anywhere. You look high and low, and still can't find anything. It wouldn't be in the dryer, or would it?

>x dryer
A rusty dryer. Nothing too much about it.

>open dryer
As you open the dryer, a loud squeek comes from the hinge of the dryer door. You freeze in fear, just in case he heard and comes to check on you. After a couple of minutes has passed, you continue searching the dryer. Using the light from inside the dryer you examine every inch of the inside. Still nothing, but as you look down as you were about to take your head out of the dryer, you see something in the lint trap. As you take out the filter, a rusty key drops to the floor.

You open the dryer, revealing a rusty key.

* * *

>take key
Taken.

>open basement door
It seems to be locked.

>use key
That's not a verb I recognise.

>unlock door with rusty key
You unlock the basement door.

* * *

>x washing mashine
I only understood you as far as wanting to examine the washing machine.

>x washing machine
As you feel around the washing machine, you feel a cylindrical object. You flip the switch on it to figure out that it is a flashlight! You are now able to examine the room better.